##########
#P...C...#
#..##..K.#
#..##....#
#....D..E#
##########
